NO textures/dog.xpm
SO textures/Goat.xpm
WE textures/cow.xpm
EA textures/hemar.xpm

F 0, 150, 0
C 0, 100, 255


111111111111111111111111111111111111111111111
100100100100100100000000000000000000000000001
100000000000000010010101000000000000100000001
100100100100100100000000011000000000000000001
100100100000100100000000011000000000000000001
100100100100100100000000000000000000000000001
1000000000000000000000000110000000N0000000001
100001111111100000000000011000000000000000001
111100000000000111000000011000000000000000001
100000010101000000000000011000000000000000001
111111111111111111111111111111111111111111111

