
NO textures/moh5.xpm
SO textures/m6.xpm
WE textures/hassan3.xpm
EA textures/hassan2.xpm

F 0,150,0
C 0,220,255

1111111111111111111111111111111111111111
1000000010010000000000000000010000D00001
1000N10000000000000000100000000100111111
1000000000001000100100000100000000000001
1000011111100000000000100000100000000001
1111111111111111111111111111111111111111
