NO textures/stone.xpm
SO textures/dirt.xpm
WE textures/oak_planks.xpm
EA textures/bamboo_planks.xpm
F 0, 150, 0
C 0, 100, 255
111111111111111
10101000000000111111111111111111111111
1000S10000000000000000000000000000000111111111111
1000000000000000000000000000000000000110000000001
1000000000000000000000000000000000000110000000001
1000000010000000000000000000000000000111111111111
10000000000001111111111111111111111111
10000100000001000000000000000000000001
10000010000000000000000000000000000001
10000000000001000000000000000000000001
11111111111111111111111111111111111111
